いがた	胃型	名詞	
いざん	遺残	名詞	
いんか	陰窩	名詞	
うしん	右心	名詞	
がんき	含気	名詞	
かんじょう	管状	名詞	
きしねんりょ	希死念慮	名詞	
きょうかく	強拡	名詞	
きんかい	菌塊	名詞	
くう	腔	名詞	
げんしょう	現象	名詞	
こいろさいとーしす	コイロサイトーシス	名詞	
こう	抗	名詞	
こうよう	膠様	名詞	
こうらく	交絡	名詞	
さしん	左心	名詞	
ざんい	残遺	名詞	
じゃっかく	弱拡	名詞	
じゅく	粥	名詞	
しょうかい	小塊	名詞	
しょうし	硝子	名詞	
しょうどく	抄読	名詞	
しょうまく	漿膜	名詞	
しょうわん	小彎	名詞	
せん	腺	名詞	
せんか	腺窩	名詞	
せんかん	腺管	名詞	
せんぼう	腺房	名詞	
そう	巣	名詞	
そくせん	塞栓	名詞	
だいわん	大彎	名詞	
たんめい	淡明	名詞	
どうじょうみゃく	動静脈	名詞	
ないくう	内腔	名詞	
のうせん	濃染	名詞	
はいほうせい	肺胞性	名詞	
ひはく	菲薄	名詞	
ほう	胞	名詞	
ほうそう	胞巣	名詞	
ほうたい	胞体	名詞	
もゆ	百佑	名詞	
よしたか	義祟	名詞	
れつげき	裂隙	名詞	
れびゅわー	レビュワー	名詞	
にくげ	肉芽	名詞	
せつり	切離	名詞	
しぼうしき	脂肪織	名詞	
ちょへん	著変	名詞	
よしたか	義崇	名詞	
